ANTICLOCKWISE	AE N T AY K L AA K W AY Z
BACKWARD	B AE K W ER D
CLOCKWISE	K L AA K W AY Z
DOWN	D AW N
FAST	F AE S T
FASTER	F AE S T ER
FORWARD	F AO R W ER D
GRIPPER	G R IH P ER
LEFT	L EH F T
MOVE	M UW V
PAUSE	P AO Z
RESUME	R IH Z UW M
RESUME(2)	R IY Z UW M
RESUME(3)	R EH Z AH M EY
RIGHT	R AY T
ROTATE	R OW T EY T
SHUTDOWN	SH AH T D AW N
SLOW	S L OW
SLOWER	S L OW ER
SPEED	S P IY D
STOP	S T AA P
SWITCH	S W IH CH
UP	AH P
